11111111111111111111111111111111111111111
1E000000000CC0000000000000000000000000001
10000000CCC00000000000000000100000000CCC1
10000000CCC00000000CCCCCC010000000000C0C1
1000N000000000C0000000000001000000000CCC1
10000000000000C00000000000010000000000001
1P000000000000C00000000CCC0100000000001C1
11111111111111111111111111111111111111111
