111111111111111111111111111111
1E000000000CCCCCC0000000000001
10000000CCCCCCC000000000000001
10000000CCCCCCC00000000CCCCCC1
10000000000000C000000000000001
1000000N000000C000000000000001
1P000000000000C00000000CCCCCC1
111111111111111111111111111111
