111111111111
1P00000C01C1
1E0C0C1N00C1
111111111111
